g y w r r b b b b r y w g r 
r w b r y b w r y g b r b g 
b w r g w b r y y r r g b b 
r b g g y b r r r b w w y b 
b g y b r b r b r w w g y r 
b w r w y g b g y r r b r b 
b r b b w b r r y g g w r y 
r g b r y b b r w w r y g b 
g w b r r g r b y r y b b w 
r r r b r g b w b y b y g w 
b b b y r r b g w g y w r r 
r y r b w b r b g b g r w y 
y w b r y g w b r b r b g r 
g r r y g y r b w b b r w b 
r b y w b w b r y b r r g g 
y g r w r b b w g b r b y r 
b g w b y r w r b b y r r g 
b w r b b b r y r g g w y r 
b y b g r r b y r r b g w w 
y w b g r r b b r b r y w g 
g r w r b r b b y w b y g r 
w g r y g b y w r b b r r b 
r g r b w g r b y y b r w b 
y b w r w g y g b r b b r r 
r r b r b r g b y g b w w y 
g y r r r w r b b y w b b g 
g r w r w b b y b b y g r r 
w w b r r y g r y r g b b b 
r b r b r r y b g b w w g y 
b b r r b r w w g y g b r y 
