r e y y g p g b r w p r w b r 
r w y r p r p b e r g b w g y 
p e r w y r b p r b w g r y g 
g r g r r w p y p b r y e w b 
g r r b r p b y p e g y w w r 
r y b p b g y g r e w r p r w 
p r e b r g p w r g r y y b w 
y p r b e r r g y r g w w b p 
b r p g p r r g e y y w w b r 
g r b r r b p p w y g e r y w 
