y g y w g r r w r b r b b e b 
y e g b w w y g r b r b r b r 
w g y r r b y e b b g w r r b 
r r y w g b e b r b b g y w r 
g g r b e y w y b w b b r r r 
e y w r b y b r b w g r g r b 
g e b b r g y w r b y r b w r 
r b b y b r r r b g e y w g w 
y w r r g y r r w b g b e b b 
g r r y g w b y e b b r b r w 
r y b b b w r g g r b r w y e 
r g b g b w y r b r b e y r w 
b w g b y r b y r b r g r e w 
r b y b g w e w r r r b b y g 
g b r w e y g r b y r r b b w 
w w e y r b b b g b r r g r y 
e g b b g r w b y y r w b r r 
w w b r r e r g b y r y b g b 
y b g g r w r e b b r w y r b 
w e r b r r r y b y g b g w b 
b b g r w e b y r r r w y b g 
y r r g e r w b r b y b g b w 
g b b r r w b w e g b r r y y 
e b b b r g r b w r w g r y y 
w e r r g w y r b y r b g b b 
r y y b b g r r w r b g w b e 
w r w b g y r g b e r b r y b 
r e w w g b g r y b r y r b b 
y r r r g w e b b w r b y b g 
w r y r b g b r r e b g w b y 
