r p w r b y y g g r b p r w 
r p y r g b r b w y g w p r 
r g p r b r y r y w g p b w 
y r w p g p r r b r y g w b 
r w p w y y g r p r b g b r 
g p y p b w w r r r b y g r 
y g g r p r r r b p y w b w 
b y y w p p r b r g r r w g 
p y b y w p g r r g w r b r 
y w r p r r g p b w r b y g 
