r b e w y g g r b w p r p r y 
r w g r r w y r b b g p y p e 
r g w r w r b y e y g b p p r 
p w r e b w r g p r b g y y r 
g p p b r r w r b g w y y r e 
b r r g b p y y g w p r e w r 
b r g w r g b r p r y p e y w 
y b w b r r p w g r g r y p e 
y w r e r p y w b g b r p g r 
r w e r y r p g b w b y p g r 
y g w r r r p e r b y w g b p 
b e b g p r g r y w r w r p y 
r y g p b r p g r w b y e w r 
r r p g y y p e r w b b r w g 
r p r w y y e g b r b g p w r 
y r r g e y r b r w p b w p g 
w g r b e r y p y w r g p r b 
y r g w w p r b g e y p r r b 
b y r e r g w w r b g y p p r 
r y w e r r w p y b g r b p g 
e g p y r r w w r g b b y p r 
y y e r r g w g b p p b w r r 
w e r b y b g w y r p g p r r 
w w g b r y y p e b r r r p g 
p e r y g r y p r b r b w w g 
w w b y r b r r g g r p p y e 
p r g b w y r y p r r b e w g 
p w w b r r y g r g y r e b p 
g r p b g w w y e r p b r y r 
b e b w r g w r y r y g p p r 
y r g p g b b r e r r w w p y 
r w g r b g e r p r b y y w p 
r y w y b b e r r r p p w g g 
e p b r r y r w g y g b p w r 
y b r r p y w e r p r g b g w 
y r w r e p g r p w g r y b b 
b p r r g b e y w g y r w r p 
w r r r p y y g p b w b e g r 
p e w y b g r y b g w r r p r 
p b y y r r g r b p w g r e w 
b g r g p b r p e w y r y r w 
b w r r w g r p p b g y r e y 
y r g b y w r r w p g e p r b 
g b r p r r w y w y r p g b e 
y r p w e r g g b y b r w p r 
p r g w r b p b w r y r y e g 
g r p w r w y r e b y r b p g 
e r w y r b w b r r g p y g p 
p g y w r w r b p b e r g r y 
p b r y b r r r g w g e y w p 
y r y r e g w b w g r b p p r 
g p e r w g w b r y r y b p r 
r g p y g r p w w e y b r b r 
g y p r b y g w w b p e r r r 
g r g r b y w y b r e w p p r 
e y r y g w b b p r g p r r w 
r g y r g p w y b p r w e b r 
r p b r w y y w r e b g r p g 
p y y b p w r b w g r r r e g 
r w g p b r r g w y b y e p r 
r g w w r p y r b r e g y p b 
b w r w r g p e b g y p r r y 
e r w r b y w p g g p r b y r 
r r r y g p r p b w g y e b w 
g b w w r g r p r e p y y r b 
r r r y b b w g w e p r g y p 
p r r y g y b w g r e r w b p 
p r r r w w e b y g y p r b g 
r y p w r w p r g e b y r g b 
b e r g g r b w r r y p p y w 
b y b g w w e g r p r r y r p 
r r y r b b p y g g w e w p r 
w y b y g e r w r r r g p p b 
r w p r g b p y r e b y w g r 
p b b w g y y p r e g r r w r 
p y g e w r p y w b r g r r b 
r p w p r y e g b g w r b r y 
r r w r b y g b p r y p e w g 
w w r g g r y e b b r y r p p 
w g b p e r y y b r p w r r g 
r b g p e w r b r r w y y p g 
g w r b r y r p p b w e r g y 
r p w g p r r r e y y b g b w 
g r w p e w r y g b r b y r p 
e g b w b r y p r r g r p w y 
y w r r b w r y p b p g e r g 
r y y w b w g b e g r r p r p 
r e g y w p w g r b p r r y b 
e g y r w b w y b p r r g p r 
b r b y y g w w g p e r p r r 
g y b p p r w b g y r r w e r 
y r w g b e r b r g p w r y p 
y r b w b r p y r g p e g r w 
r r p r b p b w e y r g w y g 
g r r p w r p b e y g b r w y 
r r b g b y w p p w y g r r e 
b p g e r b r y r r w g y w p 
g b p y y w p r w r r r e g b 
g w r g b p w y r p e r b y r 
p g b r r r p e y r w g y b w 
