r b r w b w y r b r r y b r 
b b w b y w r r y r r r r b 
r r b w w b b b r y r y r r 
b b b y w b y w r r r r r r 
r b w b w y r b y r r b r r 
r r b r w r r w b b y r b y 
b y r b b b r r r r y r w w 
b r w r b b r w r r r b y y 
w b b r b y r r r b r r w y 
r r y r w b y r b b b w r r 
y b w r w b y r r b r r r b 
r r r b b y w b r b r y r w 
y w r b b b r w r y b r r r 
w b r r b r b r r y r y b w 
w b w r r y r r b b r b r y 
r b b w r r r y r y b w r b 
y r w r r b r b w b y b r r 
b w w r b y r r r r y b b r 
r y b r b r y r w r w b r b 
y r r r b w b r b r r b y w 
w w r r r b b r r r y b b y 
b w r r b r r b w r b y y r 
b y r r b r w w r y r r b b 
y b w b r r r y r b b w r r 
r b w b r b r y b r r w y r 
r b w r y w b b r y r r b r 
b b b w y w r y r b r r r r 
r r r w b y b b y b w r r r 
r b w y b r r b r r y r b w 
b w r w r y r r b r b b y r 
b b r r r w r r b w y r y b 
r y r b w r b b b r y w r r 
b y w r y r b r r w r b r b 
y r b r r r b w y b r b w r 
w r r w y b b r y r r b r b 
r r b y r b b r y w r b r w 
r b r w w b b r b r y y r r 
w w b r r r b b r y b y r r 
b r r r r r r b w b b w y y 
r r r r y r w b w b b r b y 
r r b b r w r r r y w b b y 
y b r r r w r b b r b w r y 
r b b r w r y r w b b r r y 
w r r b y b r b r y w r r b 
b y r b y r r w r b r w b r 
b r r r w b r w r y b y b r 
r y r b r r r y b w w b r b 
r b r w r r b r w y y b b r 
b b r y b r r b y w w r r r 
w r w r r r b b r b r y y b 
