b b w b b b r r w r b r r r 
r b r b b r r b w w b r r b 
r b b r w r r b b w r b b r 
b w b r b r b r w b b r r r 
b w b r w b r b b r r r b r 
b b r r b r r b b r r w b w 
b r b r w r b r b r w b b r 
b b b r b r r r w r r b b w 
b r r b b r r b w w b r r b 
b r r b r r b w w b b r r b 
r r r w b r b b r b b b w r 
r b b w b b w r r r b r b r 
r b r b b r b r r r w w b b 
b b r w r b b w r r r b r b 
b b w b b r b w r r r r r b 
b r b b b r r r w r b w b r 
r b b b b w r r r w b r r b 
b r r w b r w b b r r b r b 
b r r r w r b b b b w b r r 
b r w r b b r b w r b r b r 
b r r w r b r r b w b r b b 
b w b r b r r b r w r b r b 
w r b w r b r b b b b r r r 
b r b b b r r r w b b r w r 
r b b r r w r b w b r b r b 
b b r r b w b r r b w b r r 
b r b b r w b b w r r r r b 
r b r b b w b w b r b r r r 
b w r b r b r b r b b r w r 
r r r r b r w r b b w b b b 
r b w r b b r r b b r r w b 
b b r r w r b r b b b r r w 
r r b r b b b r r w r w b b 
b r r r r w r b r w b b b b 
b w r r b b b b r b w r r r 
r b r r r w b b r w b b b r 
b b b r r r r w w b b r b r 
b b b r r r w r r b w b r b 
r b w r r b r w r b b b r b 
r b b r b b b r w w b r r r 
b b b w b r r r b b r r r w 
b b b w r w r r b b r b r r 
b r r b w b b b r r w r b r 
b r w w r b r r b r b b b r 
b r r b w r r r r b b b b w 
r r b r w b b r b b b r r w 
b b b b r w r r r r b r b w 
b b b r r b r b r w w b r r 
r w b r r b b r b b r w r b 
b b b r b w r b b r r r w r 
