w b r b y r r y w r b r e b r 
b r b b r y r r w y r e w b r 
w b b r r y e r r b r r b w y 
b b r r b y w y r b r e r r w 
e r r r r w y w r b y b r b b 
e r w r r y b w r r b r b y b 
b w w r y r y r e b r b r b r 
r r b w y r r b b b e y r w r 
y b b r e r r y b w b r r r w 
r y w w b r r b y r b e b r r 
b w e b w y r b y r r r r b r 
w b r r w e y y r b b b r r r 
r y r r e b y b r r b w w b r 
y w w r b b r r b r e b y r r 
b r w r r w r b y b y r b r e 
e w y r r r b r r y b b r b w 
r w r b b r b w b r y e r y r 
r b w b y w y r r b e r r r b 
b r r b w e y w b r r r r b y 
b e b y r w r r r w r r b y b 
w r b r r r y r b r b w y e b 
r y b w e y b r w r r r r b b 
r r w y r b r b b y r e b w r 
r r b r b w e r b b y r w y r 
r w r w e b y r b r r b b r y 
r r w r y b y r w b b r r b e 
r y e r b w b b w r b r r r y 
r r w b b y r r e w y r r b b 
y b e r b r w b w r b r r r y 
w r e b r y b r b b w y r r r 
y b e r b r r r b r b r w y w 
b r r w b y r r w r b e y b r 
r r w b e w y b r r b y r r b 
r b y b r r b r b w r r w y e 
r e r w b r r r r y b b w y b 
r b w y r y w r b b r r b r e 
r w e r y b r r b b r b y r w 
r w w r b b b r y e r b r r y 
r y b r r r b b y b r r w w e 
r b r e w w r b y r r y r b b 
b b r b r e r r y w w y r b r 
b b r w b r r r y y r w b r e 
r w y b r e b r r b r w y b r 
w r b r b b e w y r r y r b r 
r y w r b r r b r b y r w b e 
r b b b r y r y w r w b r r e 
b e y r w y b b w r r b r r r 
e r r r w w r b r r y b y b b 
w r r b e r y w y b r r r b b 
b y r r w y r b b w r r b r e 
